01111111111111111118
4222222222X222222225
4222222222222222X225
4222TYX222X222222225
42222222222222222225
422222222TY222222225
42222222222222222225
42222222222222222225
42222222222222222225
422222X222222222TY25
4222222X222222222225
42222222222222222225
422222TY22222222TY25
42222222222222222225
42222222222222222225
4222TY22X22222X222X5
42222222222222222225
4222TY22222222222225
4222222222222222X225
63333333333333333337